21
47
HHHHHHHHHHHHHHHHHHHH
H                  H
H                  H
H                  H
H                  H
H                  H
H               1  H
H           SSSSSFFH
H                 CH
H                ##H
H    C             H
H    ##            H
H                  H
H                  H
H                  H
H            C     H
H            ##    H
H                  H
H    C             H
H    ##            H
H                  H
H                  H
H    SSSSSSSSSSSSSSH
H                  H
H                  H
H^^IIIIIIIIIII C   H
H        C         H
H                  H
H    IIIIIIIIIIII^^H
H    ^^^^^^^^^^^^^^H
H             SSSSSH
H        C    SSSSSH
HSSF   ####   SSSSSH
H                  H
H                  H
H                  H
H    ##     ##     H
H                  H
H                  H
HC                CH
H###            ###H
H       ####       H
H                  H
H                  H
H     S            H
H 0  SSS           H
HSSSSSSS###########H