30
20
H                           H
H                           H
H                           H
H                           H
H                           H
H                           H
H                           H
HC         D     D         CH
H#     #            #      #H
H                           H
H           C   C           H
H C                       C H
H #                       # H
H                           H
H                           H
H  C        L 0 R        C  H
H  #         SSS         #  H
H                           H
H             1             H
H             #             H