30
20
H                           H
H                           H
H                           H
H                           H
H                           H
H                           H
H                           H
HC                         CH
H#     #            #      #H
H                           H
H           C   C           H
H C                       C H
H #                       # H
H                           H
H    C                C     H
H             0             H
H  #         SSS         #  H
H                           H
H             1             H
H             #             H