15
26
H             H
H             H
H             H
H             H
H             H
H             H
H   D     D   H
H      0      H
H      S      H
H             H
H  CC  C  CC  H
H  CC  C  CC  H
H  CC  C  CC  H
H   #  #  #   H
H             H
H  CC  C  CC  H
H  CC  C  CC  H
H  CC  C  CC  H
H   #  #  #   H
H             H
H  CC  C  CC  H
H  CC  C  CC  H
H  CC  1  CC  H
H   #  #  #   H
H             H
H             H