9
60
H       H
H       H
H       H
H       H
H       H
H       H
H   1   H
H       H
H   U   H
H       H
H   C   H
H   #   H
H  ^    H
H  S    H
H  S  U H
H  S    H
H       H
H   C   H
H   #   H
H    ^  H
H    S  H
H U  S  H
H    S  H
H       H
H   C   H
H   #   H
H  ^    H
H  S    H
H  S  U H
H  S    H
H       H
H   C   H
H   #   H
H    ^  H
H    S  H
H U  S  H
H    S  H
H       H
H   C   H
H   #   H
H  ^    H
H  S    H
H  S  U H
H  S    H
H       H
H   C   H
H   #   H
H    ^  H
H    S  H
H U  S  H
H    S  H
H       H
H   C   H
H   #   H
H  ^    H
H  S    H
H  S  U H
H  S    H
H  S0   H
H  SS   H