40
40
H                                      H
H                                      H
H                                      H
H                                      H
H                                      H
H                                      H
H                                      H
H      R         L                     H
H      C             C                 H
H      ##           ###                H
H                          L         1 H
H                                    ##H
H                           #########  H
H                                      H
H                         U            H
H                                      H
H                                      H
H                          ^^^IIIIII   H
H                                      H
H                                    C H
H                                   ## H
H                                  #   H
H                            R         H
H                          C U         H
H                          #           H
H                                      H
H                                      H
H                   R                  H
H                 C U                  H
H                 #                    H
H                                      H
H             R                        H
H           C U                        H
H       R   #                          H
H       U                              H
H     C                                H
H  R  #                                H
H  U                                   H
H0                                     H
HS                                     H